{
  "id": "ancient_forest",
  "name": "Ancient Forest",
  "width": 20,
  "height": 20,
  "tilewidth": 32,
  "tileheight": 32,
  "layers": [
    {
      "name": "groundLayer",
      "data": [
        1,1,1,1,1,1,1,1,2,2,2,2,1,1,1,1,1,1,1,1,
        1,5,5,5,1,1,1,1,2,2,2,2,1,1,1,5,5,5,1,1,
        1,5,5,5,5,1,1,1,2,2,2,2,1,1,5,5,5,5,5,1,
        1,5,5,5,5,1,1,1,2,2,1,1,1,1,5,5,5,5,5,1,
        1,1,5,5,1,1,1,1,2,2,1,1,1,1,1,1,5,1,1,1,
        1,1,1,1,1,1,1,1,2,2,1,1,1,1,1,1,1,1,1,1,
        1,5,5,5,5,5,1,1,2,2,1,1,5,5,5,5,5,5,1,1,
        1,5,5,5,5,5,1,1,2,2,1,1,5,5,5,5,5,5,1,1,
        1,5,5,5,5,5,1,1,2,2,1,1,5,5,5,5,5,5,1,1,
        1,1,1,1,1,1,2,2,2,2,2,2,1,1,1,1,1,1,1,1,
        1,1,1,1,1,1,2,2,2,2,2,2,1,1,1,1,1,1,1,1,
        1,5,5,5,1,1,1,1,2,2,1,1,1,1,5,5,5,5,1,1,
        1,5,5,5,1,1,1,1,2,2,1,1,1,1,5,5,5,5,1,1,
        1,1,1,1,1,1,1,1,2,2,1,1,1,1,1,1,1,1,1,1,
        1,1,1,1,1,1,1,1,2,2,1,1,1,1,1,1,1,1,1,1,
        1,1,5,5,5,5,1,1,2,2,1,1,1,5,5,5,5,1,1,1,
        1,1,5,5,5,5,1,1,2,2,1,1,1,5,5,5,5,1,1,1,
        1,1,1,1,1,1,1,1,2,2,1,1,1,1,1,1,1,1,1,1,
        1,1,1,1,1,1,1,1,2,2,1,1,1,1,1,1,1,1,1,1,
        1,1,1,1,1,1,1,1,2,2,1,1,1,1,1,1,1,1,1,1
      ]
    },
    {
        "name": "encounterLayer",
        "data": [
          0,0,0,0,0,0,0,0,0,0,0,0,0,0,0,0,0,0,0,0,
          0,5,5,5,0,0,0,0,0,0,0,0,0,0,0,5,5,5,0,0,
          0,5,5,5,5,0,0,0,0,0,0,0,0,0,5,5,5,5,5,0,
          0,5,5,5,5,0,0,0,0,0,0,0,0,0,5,5,5,5,5,0,
          0,0,5,5,0,0,0,0,0,0,0,0,0,0,0,0,5,0,0,0,
          0,0,0,0,0,0,0,0,0,0,0,0,0,0,0,0,0,0,0,0,
          0,5,5,5,5,5,0,0,0,0,0,0,5,5,5,5,5,5,0,0,
          0,5,5,5,5,5,0,0,0,0,0,0,5,5,5,5,5,5,0,0,
          0,5,5,5,5,5,0,0,0,0,0,0,5,5,5,5,5,5,0,0,
          0,0,0,0,0,0,0,0,0,0,0,0,0,0,0,0,0,0,0,0,
          0,0,0,0,0,0,0,0,0,0,0,0,0,0,0,0,0,0,0,0,
          0,5,5,5,0,0,0,0,0,0,0,0,0,0,5,5,5,5,0,0,
          0,5,5,5,0,0,0,0,0,0,0,0,0,0,5,5,5,5,0,0,
          0,0,0,0,0,0,0,0,0,0,0,0,0,0,0,0,0,0,0,0,
          0,0,0,0,0,0,0,0,0,0,0,0,0,0,0,0,0,0,0,0,
          0,0,5,5,5,5,0,0,0,0,0,0,0,5,5,5,5,0,0,0,
          0,0,5,5,5,5,0,0,0,0,0,0,0,5,5,5,5,0,0,0,
          0,0,0,0,0,0,0,0,0,0,0,0,0,0,0,0,0,0,0,0,
          0,0,0,0,0,0,0,0,0,0,0,0,0,0,0,0,0,0,0,0,
          0,0,0,0,0,0,0,0,0,0,0,0,0,0,0,0,0,0,0,0
        ]
    }
  ],
  "spawns": [
    { "type": "npc", "x": 12, "y": 9, "id": "trainer_forest_scout", "name": "Forest Scout" }
  ],
  "warps": [
    { "x": 8, "y": 19, "targetMap": "mosslight_path", "targetX": 8, "targetY": 1 },
    { "x": 9, "y": 19, "targetMap": "mosslight_path", "targetX": 9, "targetY": 1 },
    { "x": 10, "y": 19, "targetMap": "mosslight_path", "targetX": 10, "targetY": 1 },
    { "x": 11, "y": 19, "targetMap": "mosslight_path", "targetX": 11, "targetY": 1 },
    { "x": 8, "y": 0, "targetMap": "mosslight_shrine", "targetX": 9, "targetY": 18 },
    { "x": 9, "y": 0, "targetMap": "mosslight_shrine", "targetX": 10, "targetY": 18 },
    { "x": 10, "y": 0, "targetMap": "mosslight_shrine", "targetX": 11, "targetY": 18 },
    { "x": 11, "y": 0, "targetMap": "mosslight_shrine", "targetX": 12, "targetY": 18 }
  ]
}
