{
  "id": "ancient_forest",
  "name": "Ancient Forest",
  "width": 25,
  "height": 25,
  "tilewidth": 32,
  "tileheight": 32,
  "layers": [
    {
      "name": "groundLayer",
      "data": [
        6,6,6,6,6,6,6,6,6,6,6,6,2,2,2,2,6,6,6,6,6,6,6,6,6,
        6,6,6,6,6,6,6,6,6,6,6,6,2,2,2,2,6,6,6,6,6,6,6,6,6,
        6,6,6,6,6,6,1,1,1,1,1,1,2,2,2,2,1,1,1,1,6,6,6,6,6,
        6,6,6,6,6,1,1,2,2,2,2,2,2,2,2,2,2,2,1,1,1,6,6,6,6,
        6,6,6,6,6,1,2,2,2,2,2,2,2,2,2,2,2,2,1,1,1,6,6,6,6,
        6,6,6,6,1,1,2,2,1,1,1,1,5,5,5,5,2,2,1,1,1,6,6,6,6,
        6,6,6,6,1,2,2,1,1,1,1,1,5,5,5,5,2,2,1,1,1,6,6,6,6,
        6,6,6,1,1,2,2,1,1,1,1,1,1,1,1,1,2,2,1,1,1,6,6,6,6,
        6,6,1,1,2,2,1,1,1,6,6,6,1,1,1,2,2,1,1,1,1,6,6,6,6,
        6,6,1,5,5,2,2,1,1,6,6,6,1,1,2,2,1,1,1,1,1,6,6,6,6,
        6,1,1,5,5,5,2,2,1,6,6,6,1,2,2,1,1,1,1,1,6,6,6,6,6,
        6,1,1,5,5,5,2,2,2,2,2,2,2,2,1,1,1,1,1,1,6,6,6,6,6,
        6,1,1,1,5,5,1,1,2,2,2,2,2,2,1,1,1,1,1,6,6,6,6,6,6,
        6,6,1,1,1,1,1,1,1,1,1,1,2,2,2,2,2,1,1,6,6,6,6,6,6,
        6,6,1,1,1,1,1,1,1,1,1,1,2,2,2,2,2,2,1,6,6,6,6,6,6,
        6,6,1,1,5,5,5,1,1,1,1,1,1,1,1,2,2,2,1,6,6,6,6,6,6,
        6,6,1,5,5,5,5,5,1,1,1,1,1,1,1,2,2,1,1,6,6,6,6,6,6,
        6,6,1,5,5,5,5,5,1,1,1,2,2,2,2,2,1,1,1,6,6,6,6,6,6,
        6,6,6,1,5,5,2,2,2,2,2,2,2,2,2,2,1,1,6,6,6,6,6,6,6,
        6,6,6,1,1,2,2,2,2,2,2,2,1,1,1,1,1,1,6,6,6,6,6,6,6,
        6,6,6,6,1,1,2,2,1,1,1,1,1,1,6,6,6,6,6,6,6,6,6,6,6,
        6,6,6,6,6,1,1,2,2,2,1,1,6,6,6,6,6,6,6,6,6,6,6,6,6,
        6,6,6,6,6,6,1,1,2,2,1,6,6,6,6,6,6,6,6,6,6,6,6,6,6,
        6,6,6,6,6,6,6,2,2,2,2,6,6,6,6,6,6,6,6,6,6,6,6,6,6,
        6,6,6,6,6,6,6,6,2,2,2,2,6,6,6,6,6,6,6,6,6,6,6,6,6
      ]
    },
    {
      "name": "encounterLayer",
      "data": [
        0,0,0,0,0,0,0,0,0,0,0,0,0,0,0,0,0,0,0,0,0,0,0,0,0,
        0,0,0,0,0,0,0,0,0,0,0,0,0,0,0,0,0,0,0,0,0,0,0,0,0,
        0,0,0,0,0,0,0,0,0,0,0,0,0,0,0,0,0,0,0,0,0,0,0,0,0,
        0,0,0,0,0,0,0,0,0,0,0,0,0,0,0,0,0,0,0,0,0,0,0,0,0,
        0,0,0,0,0,0,0,0,0,0,0,0,0,0,0,0,0,0,0,0,0,0,0,0,0,
        0,0,0,0,0,0,0,0,0,0,0,0,5,5,5,5,0,0,0,0,0,0,0,0,0,
        0,0,0,0,0,0,0,0,0,0,0,0,5,5,5,5,0,0,0,0,0,0,0,0,0,
        0,0,0,0,0,0,0,0,0,0,0,0,0,0,0,0,0,0,0,0,0,0,0,0,0,
        0,0,0,0,0,0,0,0,0,0,0,0,0,0,0,0,0,0,0,0,0,0,0,0,0,
        0,0,0,5,5,0,0,0,0,0,0,0,0,0,0,0,0,0,0,0,0,0,0,0,0,
        0,0,0,5,5,5,0,0,0,0,0,0,0,0,0,0,0,0,0,0,0,0,0,0,0,
        0,0,0,5,5,5,0,0,0,0,0,0,0,0,0,0,0,0,0,0,0,0,0,0,0,
        0,0,0,0,5,5,0,0,0,0,0,0,0,0,0,0,0,0,0,0,0,0,0,0,0,
        0,0,0,0,0,0,0,0,0,0,0,0,0,0,0,0,0,0,0,0,0,0,0,0,0,
        0,0,0,0,0,0,0,0,0,0,0,0,0,0,0,0,0,0,0,0,0,0,0,0,0,
        0,0,0,0,5,5,5,0,0,0,0,0,0,0,0,0,0,0,0,0,0,0,0,0,0,
        0,0,0,5,5,5,5,5,0,0,0,0,0,0,0,0,0,0,0,0,0,0,0,0,0,
        0,0,0,5,5,5,5,5,0,0,0,0,0,0,0,0,0,0,0,0,0,0,0,0,0,
        0,0,0,0,5,5,0,0,0,0,0,0,0,0,0,0,0,0,0,0,0,0,0,0,0,
        0,0,0,0,0,0,0,0,0,0,0,0,0,0,0,0,0,0,0,0,0,0,0,0,0,
        0,0,0,0,0,0,0,0,0,0,0,0,0,0,0,0,0,0,0,0,0,0,0,0,0,
        0,0,0,0,0,0,0,0,0,0,0,0,0,0,0,0,0,0,0,0,0,0,0,0,0,
        0,0,0,0,0,0,0,0,0,0,0,0,0,0,0,0,0,0,0,0,0,0,0,0,0,
        0,0,0,0,0,0,0,0,0,0,0,0,0,0,0,0,0,0,0,0,0,0,0,0,0,
        0,0,0,0,0,0,0,0,0,0,0,0,0,0,0,0,0,0,0,0,0,0,0,0,0
      ]
    },
    {
      "name": "collisionLayer",
      "data": [
        4,4,4,4,4,4,4,4,4,4,4,4,0,0,0,0,4,4,4,4,4,4,4,4,4,
        4,4,4,4,4,4,4,4,4,4,4,4,0,0,0,0,4,4,4,4,4,4,4,4,4,
        4,4,4,4,4,4,0,0,0,0,0,0,0,0,0,0,0,0,0,0,4,4,4,4,4,
        4,4,4,4,4,0,0,0,0,0,0,0,0,0,0,0,0,0,0,0,0,4,4,4,4,
        4,4,4,4,4,0,0,0,0,0,0,0,0,0,0,0,0,0,0,0,0,4,4,4,4,
        4,4,4,4,0,0,0,0,0,0,0,0,0,0,0,0,0,0,0,0,0,4,4,4,4,
        4,4,4,4,0,0,0,0,0,0,0,0,0,0,0,0,0,0,0,0,0,4,4,4,4,
        4,4,4,0,0,0,0,0,0,0,0,0,0,0,0,0,0,0,0,0,0,4,4,4,4,
        4,4,0,0,0,0,0,0,0,4,4,4,0,0,0,0,0,0,0,0,0,4,4,4,4,
        4,4,0,0,0,0,0,0,0,4,4,4,0,0,0,0,0,0,0,0,0,4,4,4,4,
        4,0,0,0,0,0,0,0,0,4,4,4,0,0,0,0,0,0,0,0,4,4,4,4,4,
        4,0,0,0,0,0,0,0,0,0,0,0,0,0,0,0,0,0,0,0,4,4,4,4,4,
        4,0,0,0,0,0,0,0,0,0,0,0,0,0,0,0,0,0,0,4,4,4,4,4,4,
        4,4,0,0,0,0,0,0,0,0,0,0,0,0,0,0,0,0,0,4,4,4,4,4,4,
        4,4,0,0,0,0,0,0,0,0,0,0,0,0,0,0,0,0,0,4,4,4,4,4,4,
        4,4,0,0,0,0,0,0,0,0,0,0,0,0,0,0,0,0,0,4,4,4,4,4,4,
        4,4,0,0,0,0,0,0,0,0,0,0,0,0,0,0,0,0,0,4,4,4,4,4,4,
        4,4,0,0,0,0,0,0,0,0,0,0,0,0,0,0,0,0,0,4,4,4,4,4,4,
        4,4,4,0,0,0,0,0,0,0,0,0,0,0,0,0,0,0,4,4,4,4,4,4,4,
        4,4,4,0,0,0,0,0,0,0,0,0,0,0,0,0,0,0,4,4,4,4,4,4,4,
        4,4,4,4,0,0,0,0,0,0,0,0,0,0,4,4,4,4,4,4,4,4,4,4,4,
        4,4,4,4,4,0,0,0,0,0,0,0,4,4,4,4,4,4,4,4,4,4,4,4,4,
        4,4,4,4,4,4,0,0,0,0,0,4,4,4,4,4,4,4,4,4,4,4,4,4,4,
        4,4,4,4,4,4,4,0,0,0,0,4,4,4,4,4,4,4,4,4,4,4,4,4,4,
        4,4,4,4,4,4,4,4,0,0,0,0,4,4,4,4,4,4,4,4,4,4,4,4,4
      ]
    }
  ],
  "spawns": [
    { "type": "npc", "x": 16, "y": 14, "id": "trainer_luke", "name": "Trainer Luke" },
    { "type": "npc", "x": 8, "y": 14, "id": "evan", "name": "Evan" }
  ],
  "warps": [
    { "x": 8, "y": 24, "targetMap": "mosslight_path", "targetX": 8, "targetY": 1 },
    { "x": 9, "y": 24, "targetMap": "mosslight_path", "targetX": 9, "targetY": 1 },
    { "x": 10, "y": 24, "targetMap": "mosslight_path", "targetX": 10, "targetY": 1 },
    { "x": 11, "y": 24, "targetMap": "mosslight_path", "targetX": 11, "targetY": 1 },
    { "x": 12, "y": 0, "targetMap": "mosslight_shrine", "targetX": 5, "targetY": 13 },
    { "x": 13, "y": 0, "targetMap": "mosslight_shrine", "targetX": 6, "targetY": 13 },
    { "x": 14, "y": 0, "targetMap": "mosslight_shrine", "targetX": 7, "targetY": 13 },
    { "x": 15, "y": 0, "targetMap": "mosslight_shrine", "targetX": 8, "targetY": 13 },
    { "x": 16, "y": 0, "targetMap": "mosslight_shrine", "targetX": 9, "targetY": 13 }
  ]
}
