{
  "id": "mosslight_shrine",
  "name": "모스라이트 제단",
  "width": 15,
  "height": 15,
  "tilewidth": 32,
  "tileheight": 32,
  "layers": [
    {
      "name": "groundLayer",
      "data": [
        4, 4, 4, 4, 4, 4, 4, 4, 4, 4, 4, 4, 4, 4, 4, 4, 4, 4, 4, 4, 4, 4, 4, 4,
        4, 4, 4, 4, 4, 4, 4, 4, 1, 1, 1, 1, 4, 2, 4, 1, 1, 1, 1, 4, 4, 4, 4, 1,
        4, 4, 1, 4, 2, 4, 1, 4, 4, 1, 4, 4, 4, 4, 1, 4, 4, 1, 4, 2, 4, 1, 4, 4,
        1, 4, 4, 4, 4, 1, 1, 1, 1, 4, 2, 4, 1, 1, 1, 1, 4, 4, 4, 4, 1, 4, 4, 1,
        4, 2, 4, 1, 4, 4, 1, 4, 4, 4, 4, 1, 4, 4, 1, 4, 2, 4, 1, 4, 4, 1, 4, 4,
        4, 4, 1, 1, 1, 1, 4, 2, 4, 1, 1, 1, 1, 4, 4, 4, 4, 1, 4, 4, 1, 4, 2, 4,
        1, 4, 4, 1, 4, 4, 4, 4, 1, 4, 4, 1, 4, 2, 4, 1, 4, 4, 1, 4, 4, 4, 4, 1,
        1, 1, 1, 4, 2, 4, 1, 1, 1, 1, 4, 4, 4, 4, 4, 4, 4, 4, 4, 2, 4, 2, 4, 2,
        4, 4, 4, 4, 6, 6, 6, 6, 6, 2, 2, 2, 2, 2, 2, 2, 6, 6, 6, 6, 6, 6, 6, 6,
        6, 6, 6, 6, 6, 2, 2, 2, 2
      ]
    },
    {
      "name": "encounterLayer",
      "data": [
        0, 0, 0, 0, 0, 0, 0, 0, 0, 0, 0, 0, 0, 0, 0, 0, 0, 0, 0, 0, 0, 0, 0, 0,
        0, 0, 0, 0, 0, 0, 0, 0, 0, 0, 0, 0, 0, 0, 0, 0, 0, 0, 0, 0, 0, 0, 0, 0,
        0, 0, 0, 0, 0, 0, 0, 0, 0, 0, 0, 0, 0, 0, 0, 0, 0, 0, 0, 0, 0, 0, 0, 0,
        0, 0, 0, 0, 0, 0, 0, 0, 0, 0, 0, 0, 0, 0, 0, 0, 0, 0, 0, 0, 0, 0, 0, 0,
        0, 0, 0, 0, 0, 0, 0, 0, 0, 0, 0, 0, 0, 0, 0, 0, 0, 0, 0, 0, 0, 0, 0, 0,
        0, 0, 0, 0, 0, 0, 0, 0, 0, 0, 0, 0, 0, 0, 0, 0, 0, 0, 0, 0, 0, 0, 0, 0,
        0, 0, 0, 0, 0, 0, 0, 0, 0, 0, 0, 0, 0, 0, 0, 0, 0, 0, 0, 0, 0, 0, 0, 0,
        0, 0, 0, 0, 0, 0, 0, 0, 0, 0, 0, 0, 0, 0, 0, 0, 0, 0, 0, 0, 0, 0, 0, 0,
        0, 0, 0, 0, 0, 0, 0, 0, 0, 0, 0, 0, 0, 0, 0, 0, 0, 0, 0, 0, 0, 0, 0, 0,
        0, 0, 0, 0, 0, 0, 0, 0, 0
      ]
    },
    {
      "name": "collisionLayer",
      "data": [
        4, 4, 4, 4, 4, 4, 4, 4, 4, 4, 4, 4, 4, 4, 4, 4, 4, 4, 4, 4, 4, 4, 4, 4,
        4, 4, 4, 4, 4, 4, 4, 4, 0, 0, 0, 0, 4, 0, 4, 0, 0, 0, 0, 4, 4, 4, 4, 0,
        4, 4, 0, 4, 0, 4, 0, 4, 4, 0, 4, 4, 4, 4, 0, 4, 4, 0, 4, 0, 4, 0, 4, 4,
        0, 4, 4, 4, 4, 0, 0, 0, 0, 4, 0, 4, 0, 0, 0, 0, 4, 4, 4, 4, 0, 4, 4, 0,
        4, 0, 4, 0, 4, 4, 0, 4, 4, 4, 4, 0, 4, 4, 0, 4, 0, 4, 0, 4, 4, 0, 4, 4,
        4, 4, 0, 0, 0, 0, 4, 0, 4, 0, 0, 0, 0, 4, 4, 4, 4, 0, 4, 4, 0, 4, 0, 4,
        0, 4, 4, 0, 4, 4, 4, 4, 0, 4, 4, 0, 4, 0, 4, 0, 4, 4, 0, 4, 4, 4, 4, 0,
        0, 0, 0, 4, 0, 4, 0, 0, 0, 0, 4, 4, 4, 4, 4, 4, 4, 4, 4, 0, 4, 0, 4, 0,
        4, 4, 4, 4, 4, 4, 4, 4, 4, 0, 0, 0, 0, 0, 0, 0, 4, 4, 4, 4, 4, 4, 4, 4,
        4, 4, 4, 4, 4, 0, 0, 0, 0
      ]
    }
  ],
  "spawns": [
    {
      "type": "npc",
      "x": 7,
      "y": 8,
      "id": "ellie",
      "name": "Ellie"
    },
    {
      "type": "npc",
      "x": 7,
      "y": 3,
      "id": "trainer_guardian_rowan",
      "name": "Guardian Rowan"
    }
  ],
  "warps": [
    {
      "x": 8,
      "y": 14,
      "targetMap": "ancient_forest",
      "targetX": 8,
      "targetY": 1
    },
    {
      "x": 9,
      "y": 14,
      "targetMap": "ancient_forest",
      "targetX": 9,
      "targetY": 1
    },
    {
      "x": 10,
      "y": 14,
      "targetMap": "ancient_forest",
      "targetX": 10,
      "targetY": 1
    },
    {
      "x": 11,
      "y": 14,
      "targetMap": "ancient_forest",
      "targetX": 11,
      "targetY": 1
    }
  ]
}
