{
  "id": "mosslight_path",
  "name": "Mosslight Path",
  "width": 20,
  "height": 20,
  "tilewidth": 32,
  "tileheight": 32,
  "layers": [
    {
      "name": "groundLayer",
      "data": [
        2,2,2,2,2,2,2,2,2,2,2,2,2,2,2,2,2,2,2,2,
        2,2,2,2,2,2,2,2,2,2,2,2,2,2,2,2,2,2,2,2,
        2,2,1,1,1,1,1,1,1,1,1,1,1,1,1,1,1,1,2,2,
        2,2,1,1,1,1,5,5,5,5,5,5,5,1,1,1,1,1,2,2,
        2,2,1,1,1,1,5,5,5,5,5,5,5,1,1,1,1,1,2,2,
        2,2,1,1,1,1,1,1,1,1,1,1,1,1,1,1,1,1,2,2,
        2,2,1,1,1,1,1,1,1,1,1,1,1,1,1,1,1,1,2,2,
        2,2,5,5,5,1,1,1,1,1,1,1,1,1,1,5,5,5,2,2,
        2,2,5,5,5,1,1,1,2,2,2,2,1,1,1,5,5,5,2,2,
        2,2,1,1,1,1,1,1,2,2,2,2,1,1,1,1,1,1,2,2,
        2,2,1,1,1,1,1,1,2,2,2,2,1,1,1,1,1,1,2,2,
        2,2,1,1,1,1,1,1,1,1,1,1,1,1,1,1,1,1,2,2,
        2,2,5,5,5,1,1,1,1,1,1,1,1,1,1,5,5,5,2,2,
        2,2,5,5,5,1,1,1,2,2,2,2,1,1,1,5,5,5,2,2,
        2,2,1,1,1,1,1,1,2,2,2,2,1,1,1,1,1,1,2,2,
        2,2,1,1,1,1,1,1,2,2,2,2,1,1,1,1,1,1,2,2,
        2,2,1,1,1,1,1,1,1,1,1,1,1,1,1,1,1,1,2,2,
        2,2,1,1,1,1,1,1,1,1,1,1,1,1,1,1,1,1,2,2,
        2,2,2,2,2,2,2,2,1,1,1,1,2,2,2,2,2,2,2,2,
        2,2,2,2,2,2,2,2,1,1,1,1,2,2,2,2,2,2,2,2
      ]
    },
    {
      "name": "encounterLayer",
      "data": [
        0,0,0,0,0,0,0,0,0,0,0,0,0,0,0,0,0,0,0,0,
        0,0,0,0,0,0,0,0,0,0,0,0,0,0,0,0,0,0,0,0,
        0,0,0,0,0,0,0,0,0,0,0,0,0,0,0,0,0,0,0,0,
        0,0,0,0,0,0,5,5,5,5,5,5,5,0,0,0,0,0,0,0,
        0,0,0,0,0,0,5,5,5,5,5,5,5,0,0,0,0,0,0,0,
        0,0,0,0,0,0,0,0,0,0,0,0,0,0,0,0,0,0,0,0,
        0,0,0,0,0,0,0,0,0,0,0,0,0,0,0,0,0,0,0,0,
        0,0,5,5,5,0,0,0,0,0,0,0,0,0,0,5,5,5,0,0,
        0,0,5,5,5,0,0,0,0,0,0,0,0,0,0,5,5,5,0,0,
        0,0,0,0,0,0,0,0,0,0,0,0,0,0,0,0,0,0,0,0,
        0,0,0,0,0,0,0,0,0,0,0,0,0,0,0,0,0,0,0,0,
        0,0,0,0,0,0,0,0,0,0,0,0,0,0,0,0,0,0,0,0,
        0,0,5,5,5,0,0,0,0,0,0,0,0,0,0,5,5,5,0,0,
        0,0,5,5,5,0,0,0,0,0,0,0,0,0,0,5,5,5,0,0,
        0,0,0,0,0,0,0,0,0,0,0,0,0,0,0,0,0,0,0,0,
        0,0,0,0,0,0,0,0,0,0,0,0,0,0,0,0,0,0,0,0,
        0,0,0,0,0,0,0,0,0,0,0,0,0,0,0,0,0,0,0,0,
        0,0,0,0,0,0,0,0,0,0,0,0,0,0,0,0,0,0,0,0,
        0,0,0,0,0,0,0,0,0,0,0,0,0,0,0,0,0,0,0,0,
        0,0,0,0,0,0,0,0,0,0,0,0,0,0,0,0,0,0,0,0
      ]
    },
    {
      "name": "collisionLayer",
      "data": [
        4,4,4,4,4,4,4,4,4,4,4,4,4,4,4,4,4,4,4,4,
        4,4,4,4,4,4,4,4,4,4,4,4,4,4,4,4,4,4,4,4,
        4,4,0,0,0,0,0,0,0,0,0,0,0,0,0,0,0,0,4,4,
        4,4,0,0,0,0,0,0,0,0,0,0,0,0,0,0,0,0,4,4,
        4,4,0,0,0,0,0,0,0,0,0,0,0,0,0,0,0,0,4,4,
        4,4,0,0,0,0,0,0,0,0,0,0,0,0,0,0,0,0,4,4,
        4,4,0,0,0,0,0,0,0,0,0,0,0,0,0,0,0,0,4,4,
        4,4,0,0,0,0,0,0,0,0,0,0,0,0,0,0,0,0,4,4,
        4,4,0,0,0,0,0,0,4,4,4,4,0,0,0,0,0,0,4,4,
        4,4,0,0,0,0,0,0,4,4,4,4,0,0,0,0,0,0,4,4,
        4,4,0,0,0,0,0,0,4,4,4,4,0,0,0,0,0,0,4,4,
        4,4,0,0,0,0,0,0,0,0,0,0,0,0,0,0,0,0,4,4,
        4,4,0,0,0,0,0,0,0,0,0,0,0,0,0,0,0,0,4,4,
        4,4,0,0,0,0,0,0,4,4,4,4,0,0,0,0,0,0,4,4,
        4,4,0,0,0,0,0,0,4,4,4,4,0,0,0,0,0,0,4,4,
        4,4,0,0,0,0,0,0,4,4,4,4,0,0,0,0,0,0,4,4,
        4,4,0,0,0,0,0,0,0,0,0,0,0,0,0,0,0,0,4,4,
        4,4,0,0,0,0,0,0,0,0,0,0,0,0,0,0,0,0,4,4,
        4,4,4,4,4,4,4,4,0,0,0,0,4,4,4,4,4,4,4,4,
        4,4,4,4,4,4,4,4,0,0,0,0,4,4,4,4,4,4,4,4
      ]
    }
  ],
  "spawns": [
    { "type": "npc", "x": 10, "y": 11, "id": "trainer_youngster_tim", "name": "Youngster Tim" },
    { "type": "npc", "x": 6, "y": 6, "id": "trainer_hiker_bob", "name": "Hiker Bob" }
  ],
  "warps": [
    { "x": 8, "y": 19, "targetMap": "greenpaw_forest", "targetX": 8, "targetY": 1 },
    { "x": 9, "y": 19, "targetMap": "greenpaw_forest", "targetX": 9, "targetY": 1 },
    { "x": 10, "y": 19, "targetMap": "greenpaw_forest", "targetX": 10, "targetY": 1 },
    { "x": 11, "y": 19, "targetMap": "greenpaw_forest", "targetX": 11, "targetY": 1 },
    { "x": 8, "y": 0, "targetMap": "ancient_forest", "targetX": 8, "targetY": 18 },
    { "x": 9, "y": 0, "targetMap": "ancient_forest", "targetX": 9, "targetY": 18 },
    { "x": 10, "y": 0, "targetMap": "ancient_forest", "targetX": 10, "targetY": 18 },
    { "x": 11, "y": 0, "targetMap": "ancient_forest", "targetX": 11, "targetY": 18 }
  ]
}
