{
  "id": "mosslight_shrine",
  "name": "Mosslight Shrine",
  "width": 15,
  "height": 15,
  "tilewidth": 32,
  "tileheight": 32,
  "layers": [
    {
      "name": "groundLayer",
      "data": [
        4,4,4,4,4,4,4,4,4,4,4,4,4,4,4,
        4,4,4,4,4,4,4,4,4,4,4,4,4,4,4,
        4,4,1,1,1,1,2,2,2,1,1,1,1,4,4,
        4,4,1,4,4,1,2,2,2,1,4,4,1,4,4,
        4,4,1,4,4,1,2,2,2,1,4,4,1,4,4,
        4,4,1,1,1,1,2,2,2,1,1,1,1,4,4,
        4,4,1,4,4,1,2,2,2,1,4,4,1,4,4,
        4,4,1,4,4,1,2,2,2,1,4,4,1,4,4,
        4,4,1,1,1,1,2,2,2,1,1,1,1,4,4,
        4,4,1,4,4,1,2,2,2,1,4,4,1,4,4,
        4,4,1,4,4,1,2,2,2,1,4,4,1,4,4,
        4,4,1,1,1,1,2,2,2,1,1,1,1,4,4,
        4,4,4,4,4,2,2,2,2,2,4,4,4,4,4,
        6,6,6,6,6,2,2,2,2,2,6,6,6,6,6,
        6,6,6,6,6,2,2,2,2,2,6,6,6,6,6
      ]
    },
    {
      "name": "encounterLayer",
      "data": [
        0,0,0,0,0,0,0,0,0,0,0,0,0,0,0,
        0,0,0,0,0,0,0,0,0,0,0,0,0,0,0,
        0,0,0,0,0,0,0,0,0,0,0,0,0,0,0,
        0,0,0,0,0,0,0,0,0,0,0,0,0,0,0,
        0,0,0,0,0,0,0,0,0,0,0,0,0,0,0,
        0,0,0,0,0,0,0,0,0,0,0,0,0,0,0,
        0,0,0,0,0,0,0,0,0,0,0,0,0,0,0,
        0,0,0,0,0,0,0,0,0,0,0,0,0,0,0,
        0,0,0,0,0,0,0,0,0,0,0,0,0,0,0,
        0,0,0,0,0,0,0,0,0,0,0,0,0,0,0,
        0,0,0,0,0,0,0,0,0,0,0,0,0,0,0,
        0,0,0,0,0,0,0,0,0,0,0,0,0,0,0,
        0,0,0,0,0,0,0,0,0,0,0,0,0,0,0,
        0,0,0,0,0,0,0,0,0,0,0,0,0,0,0,
        0,0,0,0,0,0,0,0,0,0,0,0,0,0,0
      ]
    },
    {
      "name": "collisionLayer",
      "data": [
        4,4,4,4,4,4,4,4,4,4,4,4,4,4,4,
        4,4,4,4,4,4,4,4,4,4,4,4,4,4,4,
        4,4,0,0,0,0,0,0,0,0,0,0,0,4,4,
        4,4,0,4,4,0,0,0,0,0,4,4,0,4,4,
        4,4,0,4,4,0,0,0,0,0,4,4,0,4,4,
        4,4,0,0,0,0,0,0,0,0,0,0,0,4,4,
        4,4,0,4,4,0,0,0,0,0,4,4,0,4,4,
        4,4,0,4,4,0,0,0,0,0,4,4,0,4,4,
        4,4,0,0,0,0,0,0,0,0,0,0,0,4,4,
        4,4,0,4,4,0,0,0,0,0,4,4,0,4,4,
        4,4,0,4,4,0,0,0,0,0,4,4,0,4,4,
        4,4,0,0,0,0,0,0,0,0,0,0,0,4,4,
        4,4,4,4,4,0,0,0,0,0,4,4,4,4,4,
        4,4,4,4,4,0,0,0,0,0,4,4,4,4,4,
        4,4,4,4,4,0,0,0,0,0,4,4,4,4,4
      ]
    }
  ],
  "spawns": [
    { "type": "npc", "x": 7, "y": 3, "id": "trainer_guardian_rowan", "name": "Guardian Rowan" }
  ],
  "warps": [
    { "x": 5, "y": 14, "targetMap": "ancient_forest", "targetX": 12, "targetY": 1 },
    { "x": 6, "y": 14, "targetMap": "ancient_forest", "targetX": 13, "targetY": 1 },
    { "x": 7, "y": 14, "targetMap": "ancient_forest", "targetX": 14, "targetY": 1 },
    { "x": 8, "y": 14, "targetMap": "ancient_forest", "targetX": 15, "targetY": 1 },
    { "x": 9, "y": 14, "targetMap": "ancient_forest", "targetX": 16, "targetY": 1 }
  ]
}
