{
  "id": "mosslight_shrine",
  "name": "Mosslight Shrine",
  "width": 20,
  "height": 20,
  "tilewidth": 32,
  "tileheight": 32,
  "layers": [
    {
      "name": "groundLayer",
      "data": [
        4,4,4,4,4,4,4,4,4,4,4,4,4,4,4,4,4,4,4,4,
        4,4,4,4,4,4,4,4,3,3,3,3,4,4,4,4,4,4,4,4,
        4,4,3,3,3,3,3,3,3,3,3,3,3,3,3,3,3,3,4,4,
        4,4,3,3,3,3,3,3,3,3,3,3,3,3,3,3,3,3,4,4,
        4,4,3,3,3,3,3,3,3,3,3,3,3,3,3,3,3,3,4,4,
        4,4,3,3,3,3,3,3,3,3,3,3,3,3,3,3,3,3,4,4,
        4,4,3,3,3,3,3,3,3,3,3,3,3,3,3,3,3,3,4,4,
        4,4,3,3,3,3,3,3,3,3,3,3,3,3,3,3,3,3,4,4,
        4,4,3,3,3,3,3,3,3,3,3,3,3,3,3,3,3,3,4,4,
        4,4,3,3,3,3,3,3,3,3,3,3,3,3,3,3,3,3,4,4,
        4,4,3,3,3,3,3,3,3,3,3,3,3,3,3,3,3,3,4,4,
        4,4,3,3,3,3,3,3,3,3,3,3,3,3,3,3,3,3,4,4,
        4,4,3,3,3,3,3,3,3,3,3,3,3,3,3,3,3,3,4,4,
        4,4,3,3,3,3,3,3,3,3,3,3,3,3,3,3,3,3,4,4,
        4,4,3,3,3,3,3,3,3,3,3,3,3,3,3,3,3,3,4,4,
        4,4,3,3,3,3,3,3,3,3,3,3,3,3,3,3,3,3,4,4,
        4,4,3,3,3,3,3,3,3,3,3,3,3,3,3,3,3,3,4,4,
        2,2,2,2,3,3,3,3,3,3,3,3,3,3,3,3,2,2,2,2,
        2,2,2,2,2,2,2,2,2,2,2,2,2,2,2,2,2,2,2,2,
        2,2,2,2,2,2,2,2,2,2,2,2,2,2,2,2,2,2,2,2
      ]
    },
    {
      "name": "collisionLayer",
      "data": [
        4,4,4,4,4,4,4,4,4,4,4,4,4,4,4,4,4,4,4,4,
        4,4,4,4,4,4,4,4,0,0,0,0,4,4,4,4,4,4,4,4,
        4,4,0,0,0,0,0,0,0,0,0,0,0,0,0,0,0,0,4,4,
        4,4,0,0,0,0,0,0,0,0,0,0,0,0,0,0,0,0,4,4,
        4,4,0,0,0,0,0,0,0,0,0,0,0,0,0,0,0,0,4,4,
        4,4,0,0,0,0,0,0,0,0,0,0,0,0,0,0,0,0,4,4,
        4,4,0,0,0,0,0,0,0,0,0,0,0,0,0,0,0,0,4,4,
        4,4,0,0,0,0,0,0,0,0,0,0,0,0,0,0,0,0,4,4,
        4,4,0,0,0,0,0,0,0,0,0,0,0,0,0,0,0,0,4,4,
        4,4,0,0,0,0,0,0,0,0,0,0,0,0,0,0,0,0,4,4,
        4,4,0,0,0,0,0,0,0,0,0,0,0,0,0,0,0,0,4,4,
        4,4,0,0,0,0,0,0,0,0,0,0,0,0,0,0,0,0,4,4,
        4,4,0,0,0,0,0,0,0,0,0,0,0,0,0,0,0,0,4,4,
        4,4,0,0,0,0,0,0,0,0,0,0,0,0,0,0,0,0,4,4,
        4,4,0,0,0,0,0,0,0,0,0,0,0,0,0,0,0,0,4,4,
        4,4,0,0,0,0,0,0,0,0,0,0,0,0,0,0,0,0,4,4,
        4,4,0,0,0,0,0,0,0,0,0,0,0,0,0,0,0,0,4,4,
        0,0,0,0,0,0,0,0,0,0,0,0,0,0,0,0,0,0,0,0,
        0,0,0,0,0,0,0,0,0,0,0,0,0,0,0,0,0,0,0,0,
        0,0,0,0,0,0,0,0,0,0,0,0,0,0,0,0,0,0,0,0
      ]
    }
  ],
  "spawns": [
    { "type": "npc", "x": 10, "y": 6, "id": "trainer_guardian_rowan", "name": "Guardian Rowan" }
  ],
  "warps": [
    { "x": 9, "y": 19, "targetMap": "ancient_forest", "targetX": 9, "targetY": 1 },
    { "x": 10, "y": 19, "targetMap": "ancient_forest", "targetX": 10, "targetY": 1 },
    { "x": 11, "y": 19, "targetMap": "ancient_forest", "targetX": 11, "targetY": 1 },
    { "x": 12, "y": 19, "targetMap": "ancient_forest", "targetX": 12, "targetY": 1 }
  ]
}
