{
  "id": "starwhisk_village",
  "name": "Starwhisk Village",
  "width": 20,
  "height": 20,
  "tilewidth": 32,
  "tileheight": 32,
  "layers": [
    {
      "name": "groundLayer",
      "data": [
        6,6,6,6,6,6,6,6,2,2,2,2,6,6,6,6,6,6,6,6,
        6,6,6,1,1,1,6,6,2,2,2,2,6,6,1,1,1,6,6,6,
        6,6,1,1,1,1,1,1,2,2,2,2,1,1,1,1,1,1,6,6,
        6,1,1,1,1,1,1,1,2,2,2,2,1,1,1,1,1,1,1,6,
        3,3,1,1,4,4,4,1,2,2,2,2,1,4,4,4,1,1,3,3,
        3,3,1,1,4,4,4,1,2,2,2,2,1,4,4,4,1,1,3,3,
        3,3,1,1,1,1,1,1,2,2,2,2,1,1,1,1,1,1,3,3,
        3,3,3,1,1,1,1,1,2,2,2,2,1,1,1,1,1,3,3,3,
        6,3,3,1,1,1,2,2,2,2,2,2,2,2,1,1,1,3,3,6,
        6,6,3,1,1,1,2,2,2,2,2,2,2,2,1,1,1,3,6,6,
        6,6,3,1,1,1,2,2,2,2,2,2,2,2,1,2,2,6,6,6,
        6,6,3,1,1,1,2,2,2,2,2,2,2,2,1,2,1,6,6,6,
        6,6,3,1,1,1,1,1,2,2,2,2,1,1,1,2,1,6,6,6,
        6,6,3,3,1,1,1,1,2,2,2,2,6,6,6,2,6,6,6,6,
        6,6,6,3,1,1,4,4,2,2,2,2,6,1,1,2,1,1,6,6,
        6,6,6,3,1,1,4,4,2,2,2,2,6,1,1,1,1,1,6,6,
        6,6,6,3,1,1,1,1,2,2,2,2,6,6,6,6,6,6,6,6,
        6,6,6,3,3,1,1,1,2,2,2,2,6,6,6,6,6,6,6,6,
        6,6,6,6,3,3,1,1,2,2,2,2,6,6,6,6,6,6,6,6,
        6,6,6,6,6,3,3,1,2,2,2,2,6,6,6,6,6,6,6,6
      ]
    },
    {
      "name": "encounterLayer",
      "data": [
        0,0,0,0,0,0,0,0,0,0,0,0,0,0,0,0,0,0,0,0,
        0,0,0,0,0,0,0,0,0,0,0,0,0,0,0,0,0,0,0,0,
        0,0,0,0,0,0,0,0,0,0,0,0,0,0,0,0,0,0,0,0,
        0,0,0,0,0,0,0,0,0,0,0,0,0,0,0,0,0,0,0,0,
        0,0,0,0,0,0,0,0,0,0,0,0,0,0,0,0,0,0,0,0,
        0,0,0,0,0,0,0,0,0,0,0,0,0,0,0,0,0,0,0,0,
        0,0,0,0,0,0,0,0,0,0,0,0,0,0,0,0,0,0,0,0,
        0,0,0,0,0,0,0,0,0,0,0,0,0,0,0,0,0,0,0,0,
        0,0,0,0,0,0,0,0,0,0,0,0,0,0,0,0,0,0,0,0,
        0,0,0,0,0,0,0,0,0,0,0,0,0,0,0,0,0,0,0,0,
        0,0,0,0,0,0,0,0,0,0,0,0,0,0,0,0,0,0,0,0,
        0,0,0,0,0,0,0,0,0,0,0,0,0,0,0,0,0,0,0,0,
        0,0,0,0,0,0,0,0,0,0,0,0,0,0,0,0,0,0,0,0,
        0,0,0,0,0,0,0,0,0,0,0,0,0,0,0,0,0,0,0,0,
        0,0,0,0,0,0,0,0,0,0,0,0,0,0,0,0,0,0,0,0,
        0,0,0,0,0,0,0,0,0,0,0,0,0,0,0,0,0,0,0,0,
        0,0,0,0,0,0,0,0,0,0,0,0,0,0,0,0,0,0,0,0,
        0,0,0,0,0,0,0,0,0,0,0,0,0,0,0,0,0,0,0,0,
        0,0,0,0,0,0,0,0,0,0,0,0,0,0,0,0,0,0,0,0,
        0,0,0,0,0,0,0,0,0,0,0,0,0,0,0,0,0,0,0,0
      ]
    },
    {
      "name": "collisionLayer",
      "data": [
        4,4,4,4,4,4,4,4,0,0,0,0,4,4,4,4,4,4,4,4,
        4,4,4,0,0,0,4,4,0,0,0,0,4,4,0,0,0,4,4,4,
        4,4,0,0,0,0,0,0,0,0,0,0,0,0,0,0,0,0,4,4,
        4,0,0,0,0,0,0,0,0,0,0,0,0,0,0,0,0,0,0,4,
        4,4,0,0,4,4,4,0,0,0,0,0,0,4,4,4,0,0,4,4,
        4,4,0,0,4,4,4,0,0,0,0,0,0,4,4,4,0,0,4,4,
        4,4,0,0,0,0,0,0,0,0,0,0,0,0,0,0,0,0,4,4,
        4,4,4,0,0,0,0,0,0,0,0,0,0,0,0,0,0,4,4,4,
        4,4,4,0,0,0,0,0,0,0,0,0,0,0,0,0,0,4,4,4,
        4,4,4,0,0,0,0,0,0,0,0,0,0,0,0,0,0,4,4,4,
        4,4,4,0,0,0,0,0,0,0,0,0,0,0,0,0,0,4,4,4,
        4,4,4,0,0,0,0,0,0,0,0,0,0,0,0,0,0,4,4,4,
        4,4,4,0,0,0,0,0,0,0,0,0,0,0,0,0,0,4,4,4,
        4,4,4,4,0,0,0,0,0,0,0,0,4,4,4,0,4,4,4,4,
        4,4,4,4,0,0,4,4,0,0,0,0,4,0,0,0,0,0,4,4,
        4,4,4,4,0,0,4,4,0,0,0,0,4,0,0,0,0,0,4,4,
        4,4,4,4,0,0,0,0,0,0,0,0,4,4,4,4,4,4,4,4,
        4,4,4,4,4,0,0,0,0,0,0,0,4,4,4,4,4,4,4,4,
        4,4,4,4,4,4,0,0,0,0,0,0,4,4,4,4,4,4,4,4,
        4,4,4,4,4,4,4,0,4,4,4,4,4,4,4,4,4,4,4,4
      ]
    }
  ],
  "spawns": [
    { "type": "player", "x": 10, "y": 14 },
    { "type": "npc", "x": 10, "y": 8, "id": "mira", "name": "Elder Mira" },
    { "type": "npc", "x": 13, "y": 7, "id": "shopkeeper", "name": "Shopkeeper" },
    { "type": "npc", "x": 6, "y": 8, "id": "villager1", "name": "Villager" },
    { "type": "npc", "x": 15, "y": 15, "id": "item_potion", "name": "Hidden Potion" }
  ],
  "warps": [
    { "x": 8, "y": 0, "targetMap": "greenpaw_forest", "targetX": 7, "targetY": 23 },
    { "x": 9, "y": 0, "targetMap": "greenpaw_forest", "targetX": 8, "targetY": 23 },
    { "x": 10, "y": 0, "targetMap": "greenpaw_forest", "targetX": 9, "targetY": 23 },
    { "x": 11, "y": 0, "targetMap": "greenpaw_forest", "targetX": 10, "targetY": 23 }
  ]
}
