{
  "id": "starwhisk_village",
  "name": "Starwhisk Village",
  "width": 20,
  "height": 20,
  "tilewidth": 32,
  "tileheight": 32,
  "layers": [
    {
      "name": "groundLayer",
      "data": [
        1,1,1,1,1,3,3,3,1,1,1,1,1,1,1,1,1,1,1,1,
        1,1,1,1,3,3,3,3,3,1,1,1,1,1,1,1,1,1,1,1,
        1,1,1,3,3,3,1,1,1,1,1,1,1,1,1,1,1,1,1,1,
        1,1,1,3,3,1,1,1,1,1,1,1,2,2,1,1,1,1,1,1,
        1,1,1,1,1,1,1,1,1,1,1,2,2,2,2,1,1,1,1,1,
        1,1,1,1,1,1,1,1,1,1,2,2,2,2,2,2,1,1,1,1,
        1,1,1,1,1,1,1,1,1,1,2,2,2,2,2,2,1,1,1,1,
        1,1,1,1,1,1,1,1,1,1,2,2,2,2,2,2,1,1,1,1,
        1,1,1,1,1,1,1,1,1,1,2,2,2,2,2,2,1,1,1,1,
        2,2,2,2,2,2,2,2,2,2,2,2,1,1,2,2,2,2,2,2,
        2,2,2,2,2,2,2,2,2,2,2,2,1,1,2,2,2,2,2,2,
        1,1,1,1,1,1,1,1,2,2,2,2,1,1,2,2,1,1,1,1,
        1,1,1,1,1,1,1,1,2,2,2,2,1,1,2,2,1,1,1,1,
        1,1,1,1,1,1,1,1,1,1,2,2,2,2,2,1,1,1,1,1,
        1,1,1,1,1,1,1,1,1,1,1,2,2,2,1,1,1,1,1,1,
        1,1,1,1,1,1,1,1,1,1,1,1,1,1,1,1,1,1,1,1,
        1,1,1,1,1,1,1,1,1,1,1,1,1,1,1,1,1,1,1,3,
        1,1,1,1,1,1,1,1,1,1,1,1,1,1,1,1,1,3,3,3,
        1,1,1,1,1,1,1,1,1,1,1,1,1,1,1,3,3,3,3,3,
        1,1,1,1,1,1,1,1,1,1,1,1,1,3,3,3,3,3,3,3
      ]
    },
    {
      "name": "detailLayer",
      "data": [
        0,0,0,0,0,0,0,0,0,0,0,0,0,0,0,0,0,0,0,0,
        0,0,0,0,0,0,0,0,0,0,0,0,0,0,0,0,0,0,0,0,
        0,0,0,0,0,0,0,0,0,0,0,0,6,6,0,0,0,0,0,0,
        0,0,0,0,0,0,0,0,0,0,0,0,6,6,0,0,0,0,0,0,
        0,0,0,0,0,0,0,0,0,0,0,0,0,0,0,0,0,0,0,0,
        0,0,0,0,0,0,0,0,0,0,0,0,0,0,0,0,0,0,0,0,
        0,0,0,0,0,0,0,0,0,0,0,0,0,0,0,0,0,0,0,0,
        0,0,0,0,0,0,0,0,0,0,0,0,0,0,0,0,0,0,0,0,
        0,0,0,0,0,0,0,0,0,0,0,0,0,0,0,0,0,0,0,0,
        0,0,0,0,0,0,0,0,0,0,0,0,0,0,0,0,0,0,0,0,
        0,0,0,0,0,0,0,0,0,0,0,0,0,0,0,0,0,0,0,0,
        0,0,0,0,0,0,0,0,0,0,0,0,0,0,0,0,0,0,0,0,
        0,0,0,0,0,0,0,0,0,0,0,0,0,0,0,0,0,0,0,0,
        0,0,0,0,0,0,0,0,0,0,0,0,0,0,0,0,0,0,0,0,
        0,0,0,0,0,0,0,0,0,0,0,0,0,0,0,0,0,0,0,0,
        0,0,0,0,0,0,0,0,0,0,0,0,0,0,0,0,0,0,0,0,
        0,0,0,0,0,0,0,0,0,0,0,0,0,0,0,0,0,0,0,0,
        0,0,0,0,0,0,0,0,0,0,0,0,0,0,0,0,0,0,0,0,
        0,0,0,0,0,0,0,0,0,0,0,0,0,0,0,0,0,0,0,0,
        0,0,0,0,0,0,0,0,0,0,0,0,0,0,0,0,0,0,0,0
      ]
    },
    {
      "name": "collisionLayer",
      "data": [
        0,0,0,0,0,4,4,4,0,0,0,0,0,0,0,0,0,0,0,0,
        0,0,0,0,4,4,4,4,4,0,0,0,0,0,0,0,0,0,0,0,
        0,0,0,4,4,4,0,0,0,0,0,0,0,0,0,0,0,0,0,0,
        0,0,0,4,4,0,0,0,0,0,0,0,0,0,0,0,0,0,0,0,
        0,0,0,0,0,0,0,0,0,0,0,0,0,0,0,0,0,0,0,0,
        0,0,0,0,0,0,0,0,0,0,0,0,0,0,0,0,0,0,0,0,
        0,0,0,0,0,0,0,0,0,0,0,0,0,0,0,0,0,0,0,0,
        0,0,0,0,0,0,0,0,0,0,0,0,0,0,0,0,0,0,0,0,
        0,0,0,0,0,0,0,0,0,0,0,0,0,0,0,0,0,0,0,0,
        0,0,0,0,0,0,0,0,0,0,0,0,0,0,0,0,0,0,0,0,
        0,0,0,0,0,0,0,0,0,0,0,0,0,0,0,0,0,0,0,0,
        0,0,0,0,0,0,0,0,0,0,0,0,0,0,0,0,0,0,0,0,
        0,0,0,0,0,0,0,0,0,0,0,0,0,0,0,0,0,0,0,0,
        0,0,0,0,0,0,0,0,0,0,0,0,0,0,0,0,0,0,0,0,
        0,0,0,0,0,0,0,0,0,0,0,0,0,0,0,0,0,0,0,0,
        0,0,0,0,0,0,0,0,0,0,0,0,0,0,0,0,0,0,0,0,
        0,0,0,0,0,0,0,0,0,0,0,0,0,0,0,0,0,0,0,4,
        0,0,0,0,0,0,0,0,0,0,0,0,0,0,0,0,0,4,4,4,
        0,0,0,0,0,0,0,0,0,0,0,0,0,0,0,4,4,4,4,4,
        0,0,0,0,0,0,0,0,0,0,0,0,0,4,4,4,4,4,4,4
      ]
    }
  ],
  "spawns": [
    { "type": "player", "x": 10, "y": 10 },
    { "type": "npc", "x": 12, "y": 8, "id": "mira", "name": "Elder Mira" },
    { "type": "npc", "x": 8, "y": 12, "id": "shopkeeper", "name": "Village Shopkeeper" }
  ],
  "warps": [
    { "x": 9, "y": 0, "targetMap": "greenpaw_forest", "targetX": 9, "targetY": 18 },
    { "x": 10, "y": 0, "targetMap": "greenpaw_forest", "targetX": 10, "targetY": 18 }
  ]
}
